1111111111111
1ZZ00C00000C1
1ZZ0011111Z01
1P0011E000C01
1111111111111