11111111111111111
100Z00000000C00P1
100C0Z000C0000001
10Z00000000000001
10000Z0000C00Z0C1
100E00000000C0001
11111111111111111