1111111111111111111111111
1CCCCCCCCCCCCCCCCCCCCCCE1
1PCCCCCCCCCCCCCCCCCCCCCC1
1111111111111111111111111