111111111111111
10Z0000000000E1
100000CCC0000Z1
10Z000CCC0000Z1
1P0000000000001
111111111111111