1111111111111
10010ZC0000C1
1000011111Z01
1P1011E000C01
1111111111111