1111111111111
100100C0000C1
1000011111001
1P0011E000C01
1111111111111