1111111111111
100100C0000C1
1000000000001
1P0000E0000C1
1111111111111